8 8
........
.######.
..#...#.
.#..#.#.
...##...
.#...##.
.###.##.
........
